🧱🧱🧱🧱🧱🧱🧱🧱🧱🧱🧱🧱🧱🧱🧱🧱🧱🧱🧱🧱🧱
🧱🪜🧱⬜⬜⬜⬜⬜⬜⬜⬜⬜⬜⬜🚪⬜⬜⬜🚪⬜🧱
🧱🚧🧱⬜⬜⬜⬜⬜⬜⬜⬜⬜⬜⬜🧱⬜⬜⬜🧱⬜🧱
🧱⬜🚪⬜⬜⬜⬜⬜⬜⬜⬜⬜⬜⬜🧱⬜⬜⬜🧱⬜🧱
E⬜🚪⬜⬜⬜⬜⬜⬜⬜⬜⬜⬜⬜🧱⬜⬜⬜🧱⬜🧱
🧱⬜🧱⬜⬜⬜⬜⬜⬜⬜⬜⬜⬜⬜🧱⬜⬜⬜🧱⬜🧱
🧱⬜🧱⬜⬜⬜⬜⬜⬜⬜⬜⬜⬜⬜🧱⬜⬜⬜🧱⬜🧱
🧱⬜🧱⬜⬜⬜⬜⬜⬜⬜⬜⬜🧱🚪🧱🧱🧱🧱🧱⬜🧱
🧱⬜🧱⬜⬜⬜⬜⬜⬜⬜⬜⬜🧱⬜⬜⬜⬜⬜🧱⬜🧱
🧱⬜🧱⬜⬜⬜⬜⬜⬜⬜⬜⬜🧱⬜⬜⬜⬜⬜🧱⬜🧱
🧱⬜🧱⬜⬜⬜⬜⬜⬜⬜⬜⬜🧱⬜⬜⬜⬜⬜🧱⬜🧱
🧱⬜🧱⬜⬜⬜⬜⬜⬜⬜⬜⬜🧱⬜⬜⬜⬜⬜🧱⬜🧱
🧱⬜🧱⬜⬜⬜⬜⬜⬜⬜⬜⬜🧱⬜⬜⬜⬜⬜🧱⬜🧱
🧱⬜🧱⬜⬜⬜⬜⬜⬜⬜⬜⬜🧱⬜⬜⬜⬜⬜🧱⬜🧱
🧱⬜🧱⬜⬜⬜⬜⬜⬜⬜⬜⬜🧱⬜⬜⬜⬜⬜🧱⬜🧱
🧱⬜🧱⬜⬜⬜⬜⬜⬜⬜⬜⬜🧱⬜⬜⬜⬜⬜🧱⬜🧱
🧱⬜🧱🧱🧱🧱🧱🧱🧱⬜⬜⬜🧱🧱🧱🧱🧱🧱🧱🧱🧱
🧱⬜🧱⬜⬜⬜⬜⬜🚪⬜⬜⬜🚪⬜⬜⬜⬜⬜⬜⬜🧱
🧱⬜🧱⬜⬜⬜⬜⬜🧱🧱🚪🧱🧱⬜⬜⬜⬜⬜⬜⬜🧱
🧱⬜🧱⬜⬜⬜⬜⬜🧱⬜⬜⬜🧱⬜⬜⬜⬜⬜⬜⬜🧱
🧱⬜🧱⬜⬜⬜⬜⬜🧱⬜⬜⬜🧱⬜⬜⬜⬜⬜⬜⬜🧱
🧱⬜🧱⬜⬜⬜⬜⬜🧱⬜⬜⬜🧱⬜⬜⬜⬜⬜⬜⬜🧱
🧱⬜🧱⬜⬜⬜⬜⬜🧱⬜⬜⬜🧱⬜⬜⬜⬜⬜⬜⬜🧱
🧱⬜🧱⬜⬜⬜⬜⬜🧱⬜⬜⬜🧱⬜⬜⬜⬜⬜⬜⬜🧱
🧱⬜🧱⬜⬜⬜⬜⬜🧱⬜⬜⬜🧱⬜⬜⬜⬜⬜⬜⬜🧱
🧱🧱🧱🧱🧱🧱🧱🧱🧱🧱🧱🧱🧱🧱🧱🧱🧱🧱🧱🧱🧱

🧱🧱🧱🧱🧱🧱🧱🧱🧱🧱🧱🧱🧱🧱🧱🧱🧱🧱🧱🧱🧱
🧱🪜🧱⬜⬜⬜⬜⬜⬜⬜⬜⬜⬜⬜🚪⬜⬜⬜🚪⬜🧱
🧱🚧🧱⬜⬜⬜⬜⬜⬜⬜⬜⬜⬜⬜🧱⬜⬜⬜🧱⬜🧱
🧱⬜🚪⬜⬜⬜⬜⬜⬜⬜⬜⬜⬜⬜🧱⬜⬜⬜🧱⬜🧱
🧱⬜🚪⬜⬜⬜⬜⬜⬜⬜⬜⬜⬜⬜🧱⬜⬜⬜🧱⬜🧱
🧱⬜🧱⬜⬜⬜⬜⬜⬜⬜⬜⬜⬜⬜🧱⬜⬜⬜🧱⬜🧱
🧱⬜🧱⬜⬜⬜⬜⬜⬜⬜⬜⬜⬜⬜🧱⬜⬜⬜🧱⬜🧱
🧱⬜🧱⬜⬜⬜⬜⬜⬜⬜⬜⬜🧱🚪🧱🧱🧱🧱🧱⬜🧱
🧱⬜🧱⬜⬜⬜⬜⬜⬜⬜⬜⬜🧱⬜⬜⬜⬜⬜🧱⬜🧱
🧱⬜🧱⬜⬜⬜⬜⬜⬜⬜⬜⬜🧱⬜⬜⬜⬜⬜🧱⬜🧱
🧱⬜🧱⬜⬜⬜⬜⬜⬜⬜⬜⬜🧱⬜⬜⬜⬜⬜🧱⬜🧱
🧱⬜🧱⬜⬜⬜⬜⬜⬜⬜⬜⬜🧱⬜⬜⬜⬜⬜🧱⬜🧱
🧱⬜🧱⬜⬜⬜⬜⬜⬜⬜⬜⬜🧱⬜⬜⬜⬜⬜🧱⬜🧱
🧱⬜🧱⬜⬜⬜⬜⬜⬜⬜⬜⬜🧱⬜⬜⬜⬜⬜🧱⬜🧱
🧱⬜🧱⬜⬜⬜⬜⬜⬜⬜⬜⬜🧱⬜⬜⬜⬜⬜🧱⬜🧱
🧱⬜🧱⬜⬜⬜⬜⬜⬜⬜⬜⬜🧱⬜⬜⬜⬜⬜🧱⬜🧱
🧱⬜🧱🧱🧱🧱🧱🧱🧱⬜⬜⬜🧱🧱🧱🧱🧱🧱🧱🧱🧱
🧱⬜🧱⬜⬜⬜⬜⬜🚪⬜⬜⬜🚪⬜⬜⬜⬜⬜⬜⬜🧱
🧱⬜🧱⬜⬜⬜⬜⬜🧱🧱🚪🧱🧱⬜⬜⬜⬜⬜⬜⬜🧱
🧱⬜🧱⬜⬜⬜⬜⬜🧱⬜⬜⬜🧱⬜⬜⬜⬜⬜⬜⬜🧱
🧱⬜🧱⬜⬜⬜⬜⬜🧱⬜⬜⬜🧱⬜⬜⬜⬜⬜⬜⬜🧱
🧱⬜🧱⬜⬜⬜⬜⬜🧱⬜⬜⬜🧱⬜⬜⬜⬜⬜⬜⬜🧱
🧱⬜🧱⬜⬜⬜⬜⬜🧱⬜⬜⬜🧱⬜⬜⬜⬜⬜⬜⬜🧱
🧱⬜🧱⬜⬜⬜⬜⬜🧱⬜⬜⬜🧱⬜⬜⬜⬜⬜⬜⬜🧱
🧱⬜🧱⬜⬜⬜⬜⬜🧱⬜⬜⬜🧱⬜⬜⬜⬜⬜⬜⬜🧱
🧱🧱🧱🧱🧱🧱🧱🧱🧱🧱🧱🧱🧱🧱🧱🧱🧱🧱🧱🧱🧱

🧱🧱🧱🧱🧱🧱🧱🧱🧱🧱🧱🧱🧱🧱🧱🧱🧱🧱🧱🧱🧱
🧱🪜🧱⬜⬜⬜⬜⬜⬜⬜⬜⬜⬜⬜🚪⬜⬜⬜🚪⬜🧱
🧱🚧🧱⬜⬜⬜⬜⬜⬜⬜⬜⬜⬜⬜🧱⬜⬜⬜🧱⬜🧱
🧱⬜🚪⬜⬜⬜⬜⬜⬜⬜⬜⬜⬜⬜🧱⬜⬜⬜🧱⬜🧱
🧱⬜🚪⬜⬜⬜⬜⬜⬜⬜⬜⬜⬜⬜🧱⬜⬜⬜🧱⬜🧱
🧱⬜🧱⬜⬜⬜⬜⬜⬜⬜⬜⬜⬜⬜🧱⬜⬜⬜🧱⬜🧱
🧱⬜🧱⬜⬜⬜⬜⬜⬜⬜⬜⬜⬜⬜🧱⬜⬜⬜🧱⬜🧱
🧱⬜🧱⬜⬜⬜⬜⬜⬜⬜⬜⬜🧱🚪🧱🧱🧱🧱🧱⬜🧱
🧱⬜🧱⬜⬜⬜⬜⬜⬜⬜⬜⬜🧱⬜⬜⬜⬜⬜🧱⬜🧱
🧱⬜🧱⬜⬜⬜⬜⬜⬜⬜⬜⬜🧱⬜⬜⬜⬜⬜🧱⬜🧱
🧱⬜🧱⬜⬜⬜⬜⬜⬜⬜⬜⬜🧱⬜⬜⬜⬜⬜🧱⬜🧱
🧱⬜🧱⬜⬜⬜⬜⬜⬜⬜⬜⬜🧱⬜⬜⬜⬜⬜🧱⬜🧱
🧱⬜🧱⬜⬜⬜⬜⬜⬜⬜⬜⬜🧱⬜⬜⬜⬜⬜🧱⬜🧱
🧱⬜🧱⬜⬜⬜⬜⬜⬜⬜⬜⬜🧱⬜⬜⬜⬜⬜🧱⬜🧱
🧱⬜🧱⬜⬜⬜⬜⬜⬜⬜⬜⬜🧱⬜⬜⬜⬜⬜🧱⬜🧱
🧱⬜🧱⬜⬜⬜⬜⬜⬜⬜⬜⬜🧱⬜⬜⬜⬜⬜🧱⬜🧱
🧱⬜🧱🧱🧱🧱🧱🧱🧱⬜⬜⬜🧱🧱🧱🧱🧱🧱🧱🧱🧱
🧱⬜🧱⬜⬜⬜⬜⬜🚪⬜⬜⬜🚪⬜⬜⬜⬜⬜⬜⬜🧱
🧱⬜🧱⬜⬜⬜⬜⬜🧱🧱🚪🧱🧱⬜⬜⬜⬜⬜⬜⬜🧱
🧱⬜🧱⬜⬜⬜⬜⬜🧱⬜⬜⬜🧱⬜⬜⬜⬜⬜⬜⬜🧱
🧱⬜🧱⬜⬜⬜⬜⬜🧱⬜⬜⬜🧱⬜⬜⬜⬜⬜⬜⬜🧱
🧱⬜🧱⬜⬜⬜⬜⬜🧱⬜⬜⬜🧱⬜⬜⬜⬜⬜⬜⬜🧱
🧱⬜🧱⬜⬜⬜⬜⬜🧱⬜⬜⬜🧱⬜⬜⬜⬜⬜⬜⬜🧱
🧱⬜🧱⬜⬜⬜⬜⬜🧱⬜⬜⬜🧱⬜⬜⬜⬜⬜⬜⬜🧱
🧱⬜🧱⬜⬜⬜⬜⬜🧱⬜⬜⬜🧱⬜⬜⬜⬜⬜⬜⬜🧱
🧱🧱🧱🧱🧱🧱🧱🧱🧱🧱🧱🧱🧱🧱🧱🧱🧱🧱🧱🧱🧱

🧱🧱🧱🧱🧱🧱🧱🧱🧱🧱🧱🧱🧱🧱🧱🧱🧱🧱🧱🧱🧱
🧱🪜🧱⬜⬜⬜⬜⬜⬜⬜⬜⬜⬜⬜🚪⬜⬜⬜🚪⬜🧱
🧱🚧🧱⬜⬜⬜⬜⬜⬜⬜⬜⬜⬜⬜🧱⬜⬜⬜🧱⬜🧱
🧱⬜🚪⬜⬜⬜⬜⬜⬜⬜⬜⬜⬜⬜🧱⬜⬜⬜🧱⬜🧱
🧱⬜🚪⬜⬜⬜⬜⬜⬜⬜⬜⬜⬜⬜🧱⬜⬜⬜🧱⬜🧱
🧱⬜🧱⬜⬜⬜⬜⬜⬜⬜⬜⬜⬜⬜🧱⬜⬜⬜🧱⬜🧱
🧱⬜🧱⬜⬜⬜⬜⬜⬜⬜⬜⬜⬜⬜🧱⬜⬜⬜🧱⬜🧱
🧱⬜🧱⬜⬜⬜⬜⬜⬜⬜⬜⬜🧱🚪🧱🧱🧱🧱🧱⬜🧱
🧱⬜🧱⬜⬜⬜⬜⬜⬜⬜⬜⬜🧱⬜⬜⬜⬜⬜🧱⬜🧱
🧱⬜🧱⬜⬜⬜⬜⬜⬜⬜⬜⬜🧱⬜⬜⬜⬜⬜🧱⬜🧱
🧱⬜🧱⬜⬜⬜⬜⬜⬜⬜⬜⬜🧱⬜⬜⬜⬜⬜🧱⬜🧱
🧱⬜🧱⬜⬜⬜⬜⬜⬜⬜⬜⬜🧱⬜⬜⬜⬜⬜🧱⬜🧱
🧱⬜🧱⬜⬜⬜⬜⬜⬜⬜⬜⬜🧱⬜⬜⬜⬜⬜🧱⬜🧱
🧱⬜🧱⬜⬜⬜⬜⬜⬜⬜⬜⬜🧱⬜⬜⬜⬜⬜🧱⬜🧱
🧱⬜🧱⬜⬜⬜⬜⬜⬜⬜⬜⬜🧱⬜⬜⬜⬜⬜🧱⬜🧱
🧱⬜🧱⬜⬜⬜⬜⬜⬜⬜⬜⬜🧱⬜⬜⬜⬜⬜🧱⬜🧱
🧱⬜🧱🧱🧱🧱🧱🧱🧱⬜⬜⬜🧱🧱🧱🧱🧱🧱🧱🧱🧱
🧱⬜🧱⬜⬜⬜⬜⬜🚪⬜⬜⬜🚪⬜⬜⬜⬜⬜⬜⬜🧱
🧱⬜🧱⬜⬜⬜⬜⬜🧱🧱🚪🧱🧱⬜⬜⬜⬜⬜⬜⬜🧱
🧱⬜🧱⬜⬜⬜⬜⬜🧱⬜⬜⬜🧱⬜⬜⬜⬜⬜⬜⬜🧱
🧱⬜🧱⬜⬜⬜⬜⬜🧱⬜⬜⬜🧱⬜⬜⬜⬜⬜⬜⬜🧱
🧱⬜🧱⬜⬜⬜⬜⬜🧱⬜⬜⬜🧱⬜⬜⬜⬜⬜⬜⬜🧱
🧱⬜🧱⬜⬜⬜⬜⬜🧱⬜⬜⬜🧱⬜⬜⬜⬜⬜⬜⬜🧱
🧱⬜🧱⬜⬜⬜⬜⬜🧱⬜⬜⬜🧱⬜⬜⬜⬜⬜⬜⬜🧱
🧱⬜🧱⬜⬜⬜⬜⬜🧱⬜⬜⬜🧱⬜⬜⬜⬜⬜⬜⬜🧱
🧱🧱🧱🧱🧱🧱🧱🧱🧱🧱🧱🧱🧱🧱🧱🧱🧱🧱🧱🧱🧱

🧱🧱🧱🧱🧱🧱🧱🧱🧱🧱🧱🧱🧱🧱🧱🧱🧱🧱🧱🧱🧱
🧱🪜🧱⬜⬜⬜⬜⬜⬜⬜⬜⬜⬜⬜🚪⬜⬜⬜🚪⬜🧱
🧱🚧🧱⬜⬜⬜⬜⬜⬜⬜⬜⬜⬜⬜🧱⬜⬜⬜🧱⬜🧱
🧱⬜🚪⬜⬜⬜⬜⬜⬜⬜⬜⬜⬜⬜🧱⬜⬜⬜🧱⬜🧱
🧱⬜🚪⬜⬜⬜⬜⬜⬜⬜⬜⬜⬜⬜🧱⬜⬜⬜🧱⬜🧱
🧱⬜🧱⬜⬜⬜⬜⬜⬜⬜⬜⬜⬜⬜🧱⬜⬜⬜🧱⬜🧱
🧱⬜🧱⬜⬜⬜⬜⬜⬜⬜⬜⬜⬜⬜🧱⬜⬜⬜🧱⬜🧱
🧱⬜🧱⬜⬜⬜⬜⬜⬜⬜⬜⬜🧱🚪🧱🧱🧱🧱🧱⬜🧱
🧱⬜🧱⬜⬜⬜⬜⬜⬜⬜⬜⬜🧱⬜⬜⬜⬜⬜🧱⬜🧱
🧱⬜🧱⬜⬜⬜⬜⬜⬜⬜⬜⬜🧱⬜⬜⬜⬜⬜🧱⬜🧱
🧱⬜🧱⬜⬜⬜⬜⬜⬜⬜⬜⬜🧱⬜⬜⬜⬜⬜🧱⬜🧱
🧱⬜🧱⬜⬜⬜⬜⬜⬜⬜⬜⬜🧱⬜⬜⬜⬜⬜🧱⬜🧱
🧱⬜🧱⬜⬜⬜⬜⬜⬜⬜⬜⬜🧱⬜⬜⬜⬜⬜🧱⬜🧱
🧱⬜🧱⬜⬜⬜⬜⬜⬜⬜⬜⬜🧱⬜⬜⬜⬜⬜🧱⬜🧱
🧱⬜🧱⬜⬜⬜⬜⬜⬜⬜⬜⬜🧱⬜⬜⬜⬜⬜🧱⬜🧱
🧱⬜🧱⬜⬜⬜⬜⬜⬜⬜⬜⬜🧱⬜⬜⬜⬜⬜🧱⬜🧱
🧱⬜🧱🧱🧱🧱🧱🧱🧱⬜⬜⬜🧱🧱🧱🧱🧱🧱🧱🧱🧱
🧱⬜🧱⬜⬜⬜⬜⬜🚪⬜⬜⬜🚪⬜⬜⬜⬜⬜⬜⬜🧱
🧱⬜🧱⬜⬜⬜⬜⬜🧱🧱🚪🧱🧱⬜⬜⬜⬜⬜⬜⬜🧱
🧱⬜🧱⬜⬜⬜⬜⬜🧱⬜⬜⬜🧱⬜⬜⬜⬜⬜⬜⬜🧱
🧱⬜🧱⬜⬜⬜⬜⬜🧱⬜⬜⬜🧱⬜⬜⬜⬜⬜⬜⬜🧱
🧱⬜🧱⬜⬜⬜⬜⬜🧱⬜⬜⬜🧱⬜⬜⬜⬜⬜⬜⬜🧱
🧱⬜🧱⬜⬜⬜⬜⬜🧱⬜⬜⬜🧱⬜⬜⬜⬜⬜⬜⬜🧱
🧱⬜🧱⬜⬜⬜⬜⬜🧱⬜⬜⬜🧱⬜⬜⬜⬜⬜⬜⬜🧱
🧱⬜🧱⬜⬜⬜⬜⬜🧱⬜⬜⬜🧱⬜⬜⬜⬜⬜⬜⬜🧱
🧱🧱🧱🧱🧱🧱🧱🧱🧱🧱🧱🧱🧱🧱🧱🧱🧱🧱🧱🧱🧱